111111111111111111111111111111
1C10001000100010001000100010E1
1P1010101010101010101010101001
101010101010101010101010101001
101010101010101010101010101001
101010101010101010101010101001
101010101010101010101010101001
101010101010101010101010101001
101010101010101010101010101001
101010101010101010101010101001
101010101010101010101010101001
101010101010101010101010101001
101010101010101010101010101001
101010101010101010101010101001
100010001000100010001000100001
111111111111111111111111111111